1111111111
1P01E00001
1001111001
1001C10001
1001010001
1001111001
1000000001
100B000001
1111111111