11111111111111
10P000000000E1
10000000000001
11111111111111
