1111111111
1P01E00001
1001111001
1001C00001
1001000001
1001110001
1000000001
10000001C1
1111111111