1111111111
1P01E00001
1001111001
1B01C00001
1001000001
1001111001
1000000001
1000000001
1111111111
1000000001
1111111111