11111111111111
10P000000000E1
10000000000001
1C00000C000001
10000B00000001
10000000000001
11111111111111
