11111111111111
10P000000C00E1
10000000000001
11111111111111
