111111111111111111111
100010000000000000001
100010000000000000001
100010000000000000001
100011111111111110001
100010000000000000001
100010000000000000001
100010000000000000001
100011111111111110001
100000000000000000001
100000000000000000001
100000000000000000001
111111111111111111111