1111111111
1000C00001
1P000000E1
1000C00001
1111111111